70
21
0 0 0 0 0 0 0 0 0 0 0 0 0 0 0 0 0 0 0 0 0 0 0 0 0 0 0 0 27 27 27 27 0 0 0 0 0 0 0 0 0 0 0 0 0 0 0 0 0 0 0 0 0 0 0 0 0 0 0 0 0 0 0 0 0 0 0 0 0 0 
0 0 0 0 0 0 0 0 0 0 0 0 0 0 0 0 0 0 0 0 0 0 0 0 0 0 0 0 27 27 27 27 0 0 0 0 0 0 0 0 0 0 0 0 0 0 0 0 0 0 0 0 0 0 0 0 0 0 0 0 0 0 0 0 0 0 0 0 0 0 
0 0 0 0 0 0 0 0 0 0 0 0 0 0 0 0 0 0 0 0 0 0 0 0 0 0 0 0 27 27 27 27 0 0 0 0 0 0 0 0 0 0 0 0 0 0 0 0 0 0 0 0 0 0 0 0 0 0 0 0 0 0 0 0 0 0 0 0 0 0 
0 0 0 0 0 0 0 0 0 0 0 0 0 0 0 0 0 0 0 0 0 0 0 0 27 27 27 27 27 27 27 27 27 27 27 27 27 27 0 0 0 0 0 0 0 0 0 0 0 0 0 27 27 27 27 27 0 0 0 0 0 0 0 0 0 0 0 0 0 0 
0 0 0 0 0 0 0 0 0 0 0 0 0 0 0 0 0 0 0 27 27 27 27 27 27 27 27 27 27 27 27 27 27 27 27 27 27 0 0 0 26 26 26 0 0 0 0 0 0 0 0 0 27 27 27 0 0 0 0 0 0 0 0 0 0 0 0 0 0 0 
0 0 0 0 0 0 0 0 0 0 0 0 0 0 0 0 27 27 27 27 27 27 27 27 27 27 27 27 27 27 27 27 27 27 27 27 0 0 0 0 0 0 0 0 0 0 26 26 26 0 0 0 0 27 0 0 0 0 0 26 26 26 26 0 0 0 0 0 0 0 
0 0 0 0 0 0 0 0 27 27 27 27 27 27 27 27 27 27 27 27 27 27 27 27 27 27 27 27 27 27 27 27 27 27 27 0 0 0 0 0 0 0 0 0 0 0 0 0 0 0 0 0 0 0 0 0 0 0 0 0 0 0 0 0 0 0 0 0 0 0 
0 0 0 0 0 0 0 0 8 8 8 8 8 8 8 27 27 27 27 27 27 27 27 27 27 27 27 27 27 27 27 27 27 27 0 0 0 0 0 0 0 26 26 26 26 0 0 0 0 0 0 0 0 0 0 0 26 26 26 0 0 0 0 0 26 26 0 0 0 0 
0 0 0 0 0 26 0 0 8 8 8 8 8 8 8 8 27 27 27 27 27 27 27 27 27 27 27 27 27 27 27 27 27 0 0 0 0 0 0 0 0 0 0 0 0 0 0 0 0 0 0 0 0 0 0 0 0 0 0 0 0 0 0 0 0 0 0 0 0 11 
0 0 0 0 0 0 0 26 29 29 29 8 8 8 8 8 8 27 27 27 27 27 27 27 27 27 27 27 27 27 27 27 0 0 0 0 0 0 0 0 0 0 0 0 0 0 0 26 26 26 26 0 0 0 0 0 0 0 0 0 0 0 0 0 0 0 27 27 27 27 
0 0 0 0 0 0 0 0 8 8 8 8 8 8 8 8 8 0 27 27 27 27 27 27 27 27 27 27 27 27 27 0 0 0 0 0 0 0 0 0 0 0 0 0 0 0 0 0 0 0 0 0 0 0 0 0 0 0 0 0 0 0 0 0 0 0 27 27 27 27 
0 0 0 0 0 0 0 0 8 8 29 29 8 8 8 8 8 0 0 27 27 27 27 27 27 27 27 27 27 27 0 0 0 0 0 0 0 0 0 0 0 0 26 26 26 26 0 0 0 0 0 0 26 26 26 26 0 0 0 0 0 0 0 0 0 0 27 27 27 27 
0 0 0 0 0 0 0 0 8 8 8 8 8 8 29 29 8 0 0 0 0 0 0 0 0 0 0 0 0 0 0 0 0 0 0 0 0 0 0 0 0 0 0 0 0 0 0 0 0 0 0 0 0 0 0 0 0 0 0 0 0 0 0 0 0 0 27 27 27 27 
0 0 0 0 0 0 0 0 8 8 8 8 8 8 8 8 8 0 0 0 0 0 0 0 0 0 0 0 0 0 0 0 0 0 0 0 0 26 26 26 0 0 0 0 0 0 0 0 0 0 0 0 0 0 0 0 0 26 26 26 26 0 0 0 0 0 27 27 27 27 
0 0 0 0 0 0 0 0 8 29 29 29 29 8 8 8 8 0 0 0 0 0 0 0 0 0 0 0 0 0 0 0 0 0 0 0 0 0 0 0 0 0 0 0 0 0 0 0 0 0 0 0 0 0 0 0 0 0 0 0 0 0 0 0 27 27 27 27 27 27 
0 0 0 0 0 0 0 0 8 8 8 8 8 8 8 8 8 0 0 0 0 0 0 0 0 0 0 0 0 0 0 0 0 0 26 26 0 0 0 0 0 0 0 0 0 0 0 0 0 0 0 0 0 0 0 0 0 0 0 0 0 0 0 27 27 27 27 27 27 27 
0 0 0 0 0 0 0 0 8 8 29 29 29 29 29 29 8 0 0 0 0 0 26 26 26 0 0 0 0 0 0 0 0 0 0 0 0 0 0 0 0 0 0 0 0 0 0 0 0 0 0 0 0 0 0 0 0 0 0 0 0 0 27 27 27 27 27 27 27 27 
0 0 0 0 0 0 0 0 8 29 8 8 8 8 8 8 8 0 0 0 0 0 0 0 0 0 0 0 0 0 26 26 26 0 0 0 0 0 0 0 0 0 0 0 0 0 0 0 0 0 0 0 0 0 0 0 0 0 0 0 0 27 27 27 27 27 27 27 27 27 
27 27 27 27 27 27 27 27 8 8 8 8 8 8 8 8 8 27 27 27 27 0 0 0 0 0 26 26 26 0 0 0 0 0 0 0 0 0 27 27 27 27 27 27 27 27 27 0 0 0 27 27 0 0 26 26 26 0 0 0 27 27 27 27 27 27 27 27 27 27 
27 27 27 27 27 27 27 27 8 8 8 8 8 8 8 8 8 27 27 27 27 0 0 0 0 0 0 0 0 0 0 0 0 0 0 0 0 0 27 27 27 27 27 27 27 27 27 0 0 0 27 27 0 0 0 0 0 0 0 0 27 27 27 27 27 27 27 27 27 27 
27 27 27 27 27 27 27 27 8 8 8 8 8 8 8 8 8 27 27 27 27 9 9 9 9 9 9 9 9 9 9 9 9 9 9 9 9 9 27 27 27 27 27 27 27 27 27 0 0 0 27 27 0 0 0 0 0 0 0 0 27 27 27 27 27 27 27 27 27 27 
